NO ./bonus/textures/walls/wall_default_texture.xpm
EA ./bonus/textures/walls/wall_default_texture.xpm
SO ./bonus/textures/walls/wall_default_texture.xpm
WE ./bonus/textures/walls/wall_default_texture.xpm

F 45,33,16
C 111,98,232

              111
              101
              101
              101
1111111111111110111111111
10000000000000000000000011
10000000000000000000000001
10000000000000000000000011
1000000000000000000000000111111
1000000000000000000000000111
10000000000000000000000000011
10000000000040000000000000001
10000000000000000000000001001
10000000000000000000001111001
10000000000000N00000001 10001
12100000111010100001101 1000111
10000000000000000000001 10001
11110000111111100001111 11111
   1111110000000000000111
   110000000000000000111
   1111111111111111111