NO ./bonus/textures/walls/wall_default_texture.xpm
EA ./bonus/textures/walls/wall_default_texture.xpm
SO ./bonus/textures/walls/wall_default_texture.xpm
WE ./bonus/textures/walls/wall_default_texture.xpm

F 45,33,16
C 111,98,232

              111
              141
              101
              141
1111111111111110111111111
10000000000000000000000011
10000000000000000000000001
1E000000000000000000000011
1000000000000000000000000111111
1000000000000000000000000111
10000000000000400000400000011
10000000000000000000000000001
10000000000400000000000000001
10000000000000000000000000001
10000000000400000000004000001
10000000000000000000000000001
10000000000000000000000000001
10000000000000400000000000001
10000000000000000000000000041
1111111111111111111111111111111