NO ./bonus/textures/walls/wall_default_texture.xpm
SO ./bonus/textures/walls/wall_default_texture.xpm
WE ./bonus/textures/walls/wall_default_texture.xpm
EA ./bonus/textures/walls/wall_default_texture.xpm

F 145,33,16
C 111,98,232

              111
              141
              101
              101
1111111111111110111111111
1N00000000110000000000001
1011000001110000000000001
1001000000000000000000001
11111111101100000110000011111111
100000000011012110111111111111
11110111111111011100000010001
11110111111111011101111111001
11000000110101011100100001001
10000000000000001100101111001
10000000000000001101101 10001
110000001110101011111101 1000111
10000000000000000000001 10001
11110000111111111111111 11111
   111111