NO ./bonus/textures/walls/wall_default_texture.xpm
EA ./bonus/textures/walls/wall_default_texture.xpm
SO ./bonus/textures/walls/wall_default_texture.xpm
WE ./bonus/textures/walls/wall_default_texture.xpm

F 45,33,16
C 111,98,232

              111
              101
              101
              101
1111111111111110111111111
1S000000000100001000010011
10000000000000002000010001
10000000000100001000010011
11111111111100001110010011111111
1000000000110000001111111111
11110111111111000000000010001
11110111111111000001111111001
11000000110101000000100001001
10000000000000000000101111001
10000000000000000001101 10001
11000000111010100001101 1000111
10000000000000000000001 10001
11110000111111100001111 11111
   1111110000000000000111
   110000000000000000111
   1111111111111111111