NO ./mandatory/textures/walls/north_texture.xpm
SO ./mandatory/textures/walls/south_texture.xpm
WE ./mandatory/textures/walls/west_texture.xpm
EA ./mandatory/textures/walls/south_texture.xpm

F 220,100,0
C 225,30,0

1111111111111111111111111
1000000000000000000000001
1000000000000000000000001
1000000000000000000000001
1000000000000000000000001
1000000000000000000000001
1000000000000000000000001
1000000000000000000000001
100000N000000000000000001
1111111111111111111111111