NO ./bonus/textures/walls/wall_default_texture.xpm

WE ./bonus/textures/walls/wall_default_texture.xpm














EA                                    ./bonus/textures/walls/wall_default_texture.xpm


SO                                         ./bonus/textures/walls/north_texture.xpm









C                       55,0,0
F                              0,0,0


















11111111111111111111111111111111111111111111111111111
10000000000000000000000000000000000000000000000000001
10000000000000000000000000000000000000000000000000001
10000000000000000000000000000000000000000000000000001
10000000000000000000000000000000000000000000000000001
10000000000000000000000000000000000000000000000000001
10000000000000000000000000000000000000000000000000001
100000000N0000000000000000000000000000000000000000001
10000000000000000000000000000000000000000000000000001
10000000000000000000000000000000000000000000000000001
10000000000000000000000000000000000000000000000000001
10000000000000000000000000000000000000000000000000001
10000000000000000000000000000000000000000000000000001
10000000000000000000000000000000000000000000000000001
11111111111111111111111111111111111111111111111111111

