



WE assets/textures/matrix.png
EA assets/textures/matrix.png
C 0,0,0

NO assets/textures/matrix.png

SO assets/textures/matrix.png

F 20,20,20


111111111111111111111111111111111111111111111111111111
1001000000E000000000000000000000000000000000000000000001
10000000000000000101111111111100000000000000000000000001
 111000000000000001           10010000100000000100010001
    100111000000001            100100001000000100010001
 111000000000000000111111       1001000010000100010001
10000100011111100100000001       10010000100100010001
 1111000000000000100000001        100100001000010001
     10011111110000011111          1001000000010001
 1111000000000000001                11010000010001
10000100011111100001                 100100010001
 111000000000000000111111             1000000001
    100000000000010000001              10011001
11110000001000000000000001111111111111110000000111111111
100000001111100000100000000000000000000000000000000000001
 111000000000000001111111111111000010000000001110000000111
    100011100000001            1111100000011111000000000001
 111000000000000000111111       10000000000000000000011111
10000100001111000000000001       10011000011111100001
 1111000000000000100000001        100000000000000001
     10001100000000011111          1000011110000001
 1111000000111100001                10000000000001
10000100000000000001                 100001111001
 111000000111100000111111             1000000001
    100000000000010000001              10000001
     1111111111111111111                100001
                                         1111
                                         1111




