NO ./assets/textures/north.png
SO ./assets/textures/south.png
WE ./assets/textures/west.png
EA ./assets/textures/east.png


  F 220,100,0

   C 0,0,255



1011
1001
1001
1001
1111



