NO ./bonus/textures/walls/wall_default_texture.xpm
EA ./bonus/textures/walls/wall_default_texture.xpm
SO ./bonus/textures/walls/wall_default_texture.xpm
WE ./bonus/textures/walls/wall_default_texture.xpm

F 45,33,16
C 111,98,232

              111
              101
              101
              101
1111111111111110111111111
10100101000400000000000111
1S100000000000000000000001
10100400000000040000000111
1010000000000000000000000111111
12100000000000000000000000111
10100000000000000000000000011
12100000000000000000000000001
10100000000000000000000001001
12100000000000000000001111001
10000000000000000000001 10001
11111111111111111111121 1000111
10000400000000000000001 10001
11110000111111112111111 11111
   1111110000000000040111
   110000000000000000111
   1111111111111111111