NO ./bonus/textures/walls/wall_default_texture.xpm
EA ./bonus/textures/walls/wall_default_texture.xpm
SO ./bonus/textures/walls/wall_default_texture.xpm
WE ./bonus/textures/walls/wall_default_texture.xpm

F 45,33,16
C 111,98,232

              111
              101
              101
              101
1111111111111110111111111
10100101000400000000000111
1S100000000000000000000001
10101111111111111111111111
1010000000000000000000000111111
10111111111111111111111110111
10111111111111111111111111111
10100000400040000004000000001
10100000000000000000000001001
12100000000000000000001111001
10000000040000000000001 10001
11111111111111111111101 1000111
10000000000000040000001 10401
11110000111111111111121 11111
   1111110000000000000111
   110000000000004000011
   11111111111111111111