NO ./mandatory/textures/walls/wall_default_texture.xpm
SO ./mandatory/textures/walls/wall_default_texture.xpm
WE ./mandatory/textures/walls/wall_default_texture.xpm
EA ./mandatory/textures/walls/wall_default_texture.xpm

F 77,92,53
C 163,208,230

            1111111111111111111111111
            1111111111
            10000N0001
            1000000001
            1000000001
            1000000001
            1000000001
            1000000001
            1000000001
            1111111111